width = 4096
height = 2816

max_provinces = 1605
sea_starts = { 
	1 2 3 4 5 6 7 8 9 10 11 12 13 14 15 16 17 18 19 20 21 22 23 24 25 26 27 28 29 30 31 
	32 33 34 35 36 37 38 39 40 41 42 43 44 45 46 47 48 49 50 51 52 53 54 55 56 57 58 59
	60 61 62 63 64 65 66 67 68 69 70 71 72 73 74 75 76 77 78 79 80 81 82 83 84 85 86 87 
	88 89 90 91 92 93 94 95 96 97 98 99 100 101 102 103 104 105 106 107 108 109 110 111
    112 113 114 115 116 117 118 119 120 121 122 123 124 125 126 127 128 129 130 131 132
	133 134 135 136 137 138 139 140 141 142 143 144 145 146 147 148 149 150 151 152 153
    154 155 156 157 158 159 160 161 162 163 164 165 166 167 168 169 170 171 172 173 174
	175 176 177 178 179 180 181 182 183 184 185 186 187 188 189 190 191 192 193 194 195
	196 197 198 199 200 201 202 203 204 205 206 207 208 605 606 607 608 669 674 675 676
	790 791 792
	1534
}

only_used_for_random = {
}

lakes = {
	242 243 521 522 523 524 525 670 671 672 673
	1054 1055 1056 1057 1058 1059 1060 1114 1115 1116 1258 1259 1260 1261 1262 1263
	1364 1365 1366 1367 1433 1434 1435 1516	
}

force_coastal = {
}

definitions = "definition.csv"
provinces = "provinces.bmp"
positions = "positions.txt"
terrain = "terrain.bmp"
rivers = "rivers.bmp"
terrain_definition = "terrain.txt"
heightmap = "heightmap.bmp"
tree_definition = "trees.bmp"
continent = "continent.txt"
adjacencies = "adjacencies.csv"
climate = "climate.txt"
region = "region.txt"
superregion = "superregion.txt"
area = "area.txt"
provincegroup = "provincegroup.txt"
ambient_object = "ambient_object.txt"
seasons = "seasons.txt"
trade_winds = "trade_winds.txt"

# Define which indices in trees.bmp palette which should count as trees for automatic terrain assignment
tree = { 3 4 7 10 }
